ALT	/action/feature/feature-detail?zdbID=ZDB-ALT
ANAT	/action/anatomy/term-detail?anatomyItem.zdbID=ZDB-ANAT
ATB	/action/marker/view/ZDB-ATB
BAC	/action/marker/view/ZDB-BAC
BAC_END	/action/marker/view/ZDB-BAC_END
CDNA	/action/marker/view/ZDB-CDNA
COMPANY	/action/profile/view/ZDB-COMPANY
CONSTRCT	/action/marker/view/ZDB-CONSTRCT
EFG	/action/marker/view/ZDB-EFG
EST	/action/marker/view/ZDB-EST
ETCONSTRCT	/action/marker/view/ZDB-ETCONSTRCT
EXP	/action/expression/experiment?id=ZDB-EXP
FIG	/<!--|WEBDRIVER_PATH_FROM_ROOT|-->?MIval=aa-fxfigureview.apg&OID=ZDB-FIG
FOSMID	/action/marker/view/ZDB-FOSMID
GENE	/action/marker/view/ZDB-GENE
GENEFAMILY	/action/marker/view/ZDB-GENEFAMILY
GENEP	/action/marker/view/ZDB-GENEP
GENO	/action/genotype/genotype-detail?zdbID=ZDB-GENO
GO	/action/ontology/term-detail?termID=GO
GTCONSTRCT	/action/marker/view/ZDB-GTCONSTRCT
IMAGE	/<!--|WEBDRIVER_PATH_FROM_ROOT|-->?MIval=aa-imageview.apg&OID=ZDB-IMAGE
LAB	/action/profile/view/ZDB-LAB
MRPHLNO	/action/marker/view/ZDB-MRPHLNO
PAC	/action/marker/view/ZDB-PAC
PAC_END	/action/marker/view/ZDB-PAC_END
PATO	/action/ontology/term-detail?termID=PATO
PERS	/action/profile/view/ZDB-PERS
PGCONSTRCT	/action/marker/view/ZDB-PGCONSTRCT
PTCONSTRCT	/action/marker/view/ZDB-PTCONSTRCT
PUB	/<!--|WEBDRIVER_PATH_FROM_ROOT|-->?MIval=aa-pubview2.apg&OID=ZDB-PUB
RAPD	/action/marker/view/ZDB-RAPD
REFCROSS	/<!--|WEBDRIVER_PATH_FROM_ROOT|-->?MIval=aa-crossview.apg&OID=ZDB-REFCROSS
REGION	/action/marker/view/ZDB-REGION
SNP	/action/marker/view/ZDB-SNP
SSLP	/action/marker/view/ZDB-SSLP
STS	/action/marker/view/ZDB-STS
TGCONSTRCT	/action/marker/view/ZDB-TGCONSTRCT
TSCRIPT	/action/marker/view/ZDB-TSCRIPT
XPAT   /<!--|WEBDRIVER_PATH_FROM_ROOT|-->?MIval=aa-fxallfigures.apg&xpatID=ZDB-XPAT
ZFA     /action/anatomy/anatomy-view/ZFA
